Uncle Clifton is dead.

[Press ENTER to continue.]

>help
> Introduction to Uncle Albert in a Can
   Instructions for Play

>[enter]
This is a simple demonstration Comedy game.

Please press SPACE to continue.

> Introduction to Uncle Albert in a Can
   Instructions for Play

 > Introduction to Uncle Albert in a Can
   Instructions for Play

>[down]
Introduction to Uncle Albert in a Can
 > Instructions for Play

   Introduction to Uncle Albert in a Can
 > Instructions for Play

>[up]
> Introduction to Uncle Albert in a Can
   Instructions for Play

 > Introduction to Uncle Albert in a Can
   Instructions for Play

>q
Foyer
The foyer of a home.

>look
Foyer
The foyer of a home.

* * *

Uncle Clifton is dead.

[Press ENTER to continue.]

>[enter]
He wasn't even really your uncle. Something like a father of a cousin of an in-law. A guy you mostly met at reunions at his house when you were a kid, the guy with the family that hates you.

>wait
Time passes.

>wait
Time passes.

>wait
Time passes.

> take umbrella
You stuff it in your pocket as surreptitiously as you can.

>look
Vestibule
The entranceway of Uncle Clifton's imposing mansion. On your left, a weathered wooden umbrella stand sits  nothing

* * *

>wait
Time passes.

>i
You are carrying:
  Testthing

>wait
Time passes.

>wait
Time passes.

Taken.

hey don't take that

>i
You are carrying:
  Anotherthing
  Testthing

>wait
Time passes.

>wait
Time passes.

Your fingers itch.

You feel eyes on you.

>n
Newroom
Doesn't matter.

>look
Newroom
Doesn't matter.

>jump
You jump on the spot.

Taken.

>i
You are carrying:
  Differentthing
  Anotherthing
  Testthing

>wait
Time passes.

>wait
Time passes.

Your fingers itch.

* * *

>wait
Time passes.

>[enter]
You just can't help yourself, can you.

>[enter]
"THIEF! THIEF!"

>[enter]
*** You have been thrown out ***

Would you like to RESTART, RESTORE a saved game, QUIT or UNDO the last command?

>undo
Foyer
[Previous turn undone.]

>wait
Time passes.

> take Anotherthing
You stuff it in your pocket as surreptitiously as you can.

>[enter]
You just can't help yourself, can you.

* * *

>undo
Foyer
[Previous turn undone.]

>n
Newroom
s

> take Differentthing
You stuff it in your pocket as surreptitiously as you can.

>undo
Foyer
[Previous turn undone.]

>undo
Foyer
[Previous turn undone.]

>n
Newroom
s

>wait
Time passes.

> take Differentthing
You stuff it in your pocket as surreptitiously as you can.

* * *

>undo
Foyer
[Previous turn undone.]

>n
Newroom
s

> take 
You stuff it in your pocket as surreptitiously as you can.

>i
You are carrying nothing.

* * *

>wait
Time passes.

>n
Newroom
s

>wait
Time passes.

>wait
Time passes.

Differentthing
> take *** Couldn't read from entry 1 of a list which is empty ***

*** Run-time problem P50: Attempt to use list item which does not exist.

nothing
You stuff it in your pocket as surreptitiously as you can.
Differentthing

* * *

>wait
Time passes.

>ait
That's not a verb I recognise.

>wait
Time passes.

>x umbrella stand
The umbrella stand is empty.

* * *

>[enter]
He wasn't even really your uncle. Something like a father of a cousin of an in-law. A guy you mostly met at reunions at his house when you were a kid, the guy with the family that hates you.

>n
Hall
s

You can see Cartwright here.

>look
Newroom
Differentthing

>look
Newroom
Differentthing
Taken.

hey don't take that

>i
You are carrying:
  Differentthing

* * *

>n
Hall
s

You can see Cartwright here.

>wait
Time passes.

>wait
Time passes.

> take Foo
You stuff it in your pocket as surreptitiously as you can.

>wait
Time passes.

>wait
Time passes.

You already have that.

* * *

>wait
Time passes.

> take Foo
You stuff it in your pocket as surreptitiously as you can.

>s
Foyer
The foyer of your uncle's home. Testthing and Anotherthing

You can see John here.

>x john
John.

>wait
Time passes.

>wait
Time passes.

> take Differentthing and Testthing
You stuff it in your pocket as surreptitiously as you can.

* * *

>s
Foyer
The foyer of your uncle's home. Testthing and Anotherthing

You can see John here.

>wait
Time passes.

* * *

>s
Foyer
The foyer of your uncle's home. Testthing and Anotherthing

You can see John here.

>s
You can't go that way.

>wait
Time passes.

>wait
Time passes.

Anotherthing
> take Anotherthing
You stuff it in your pocket as surreptitiously as you can.

>[enter]
You just can't help yourself, can you.

* * *

>undo
Foyer
[Previous turn undone.]

>lick john
That's not a verb I recognise.

>smell john
You smell nothing unexpected.

* * *

>s
Foyer
The foyer of your uncle's home. Testthing and Anotherthing

You can see John here.

>give differentthing to john
It might not be a good idea to give grieving rich people concrete evidence that you're stealing from them.

Even rich people who aren't grieving tend to be extra-vindictive about that sort of thing.

>kiss john
John might not like that.

>touch john
John might not like that.

>pick up john
I don't suppose John would care for that.

* * *

>wait
Time passes.

> take Foo
You stuff it in your pocket as surreptitiously as you can.

>i
You are carrying:
  Differentthing

>w
You can't go that way.

>wait
Time passes.

* * *

>wait
Time passes.

Your fingers itch.

>s
Foyer
The foyer of your uncle's home.

You can see John here.

>s
You can't go that way.

>s
You can't go that way.

>wait
Time passes.

> take Differentthing and Anotherthing
You stuff it in your pocket as surreptitiously as you can.

* * *

>wait
Time passes.

> take Foo
You stuff it in your pocket as surreptitiously as you can.

>[enter]
You just can't help yourself, can you.

* * *

>n
Hall
s

You can see Cartwright here.

>s
Foyer
The foyer of your uncle's home.

>wait
Time passes.

Taken.

>i
You are carrying:
  Testthing

>n
Newroom
Doesn't matter.

>wait
Time passes.

You already have that.

>i
You are carrying:
  Testthing

* * *

>n
Hall
s

You can see Cartwright here.

>n
You can't go that way.

>wait
Time passes.

>wait
Time passes.

Differentthing
> take Differentthing
You stuff it in your pocket as surreptitiously as you can.

>s
Foyer
The foyer of your uncle's home.

You can see John here.

>wait
Time passes.

* * *

>n
Hall
s

You can see Cartwright here.

>give wallet to cartwright
(Cartwright)
That would be a really, really, really bad idea. I don't think he'll believe you if you claim you "just found it."

>give wallet
(to Cartwright)
That would be a really, really, really bad idea. I don't think he'll believe you if you claim you "just found it."

* * *

>n
Hall
s

You can see Cartwright here.

>give wallet to Cartwright
(Cartwright)
That would be a really, really, really bad idea. I don't think he'll believe you if you claim you "just found it."

* * *

>n
Hall
s

You can see Cartwright here.

>se
You can't go that way.

>give wallet
(to Jack)
The family is already watching you like a hawk, if you give it to one of them they'll probably think you stole it.

I beg your pardon?

* * *

>give wallet
(to Jack)
The family is already watching you like a hawk, if you give it to one of them they'll probably think you stole it.

>[enter]
Which, to be fair, you did.

>nw
hall
s

You can see Cartwright here.

>give wallet
(to Cartwright)
The family is already watching you like a hawk, if you give it to one of them they'll probably think you stole it.

>[enter]
Which, to be fair, you did.

* * *

>se
You can't go that way.

>look door
You can't see any such thing.

>look locked door
You see nothing special about the door to the Library.

>x library door
You see nothing special about the door to the Library.

>x door library
You can't see any such thing.

>x door to library
You see nothing special about the door to the Library.

>unlock library door
(with Cartwright's wallet)
That doesn't seem to fit the lock.

* * *

>se
You can't go that way.

>x library
You can't see any such thing.

>x library door
Normally, this door leads to one of your favorite rooms in the house. Uncle Clifton kept a terrific mix of old newspapers, new science texts, gothic horror...you name it.

Unfortunately, the door is locked.

>x kitchen
You can't see any such thing.

* * *

>n
Hall
s

You can see Cartwright here.

>give wallet
(to Cartwright)
That would be a really, really, really bad idea. I don't think he'll believe you if you claim you "just found it."

>se
Sitting Room
Description of sitting room. Further south in the room, there's an hors d'oeuvres table.

You can see Jack here.

>give wallet to jack
That wouldn't be a great idea. The family is already watching you like a hawk, they'll probably think you stole it.
Which, to be fair, you did.

* * *

>se
Sitting Room
Description of sitting room. Further south in the room, there's an hors d'oeuvres table.

You can see Jack here.

>give wallet
(to Jack)
The family is already watching you like a hawk, if you give it to one of them they'll probably think you stole it.

* * *

>give wallet
(to Cartwright)
That would be a really, really, really bad idea. I don't think he'll believe you if you claim you "just found it."

>[enter]
Which, to be fair, you did.

* * *

>n
Hall
s

You can see Cartwright here.

>drop
(Cartwright's wallet)
It might not be a good idea to give grieving rich people concrete evidence that you're stealing from them.

* * *

>n
Hall
s

You can see Cartwright here.

>x vestibule
You can't see any such thing.

* * *

>n
Hall
s

You can see Cartwright here.

>sw
Sitting Room
A crowd of family and friends share condolences and fond memories of Uncle Clifton, drink champagne, and eat the hors d'oeuvres that remain on their napkins. Dimia sits in the middle of it all, looking past you, a hard-to-read expression on her face. The couch is loaded down with stuff: a pack of cigarettes and its ashtray, balanced precariously; a clutch; a cardigan and a leather jacket, draped over the couch next to each other; an empty china plate; and a golden watch. A chess set sits to the side of the room, on a game table, and a forgotten champagne flute sits on top of it.

To the west, a door is open to the lawn, where the remaining hors d'oeuvres are laid out. Barely anyone's out there.

>x dimia
Uncle Clifton's daughter. Her expression is inscrutable, but it seems to suggest a vague notion of sorrow.

Dimia doesn't like you. But then, almost nobody in the family does.

>x dimia
Dimia doesn't like you. But then, almost nobody in the family does.

>wait
Time passes.

>wait
Time passes.

> take clutch
You stuff it in your pocket as surreptitiously as you can.

>w
You just can't help yourself, can you.

>w
"THIEF! THIEF!"

>[enter]
*** You have been thrown out ***

Would you like to RESTART, RESTORE a saved game, QUIT or UNDO the last command?

* * *

>x cigarettes
You look down at the half-empty pack of cigarettes. The weirdly sexually-charged camel mascot stares back at you through his Ray-Ban sunglasses.

* * *

>[enter]
He wasn't even really your uncle. Something like a father of a cousin of an in-law. A guy you mostly met at reunions at his house when you were a kid, the guy with the family that hates you.

>ask john about thing
There is no reply.

>tell john about god
This provokes no reaction.

* * *

>[enter]
He wasn't even really your uncle. Something like a father of a cousin of an in-law. A guy you mostly met at reunions at his house when you were a kid, the guy with the family that hates you.

>x john
John.

>look
Foyer
The foyer of your uncle's home.

You can see John here.

>s
You can't go that way.

>e
You can't go that way.

>w
You can't go that way.

>nw
You can't go that way.

>n
Newroom
s

> take Differentthing
You stuff it in your pocket as surreptitiously as you can.

* * *

>[enter]
He wasn't even really your uncle. Something like a father of a cousin of an in-law. A guy you mostly met at reunions at his house when you were a kid, the guy with the family that hates you.

>take testthing
BLEH

>wait
Time passes.

>wait
Time passes.

> take Testthing and Anotherthing
You stuff it in your pocket as surreptitiously as you can.

>[enter]
hey don't take that

* * *

>[enter]
He wasn't even really your uncle. Something like a father of a cousin of an in-law. A guy you mostly met at reunions at his house when you were a kid, the guy with the family that hates you.

>look
Foyer
The foyer of your uncle's home.

You can see John here.

>x john
John.

>wait
Time passes.

> take Anotherthing
You stuff it in your pocket as surreptitiously as you can.

>[enter]
hey don't take that

* * *

>[enter]
He wasn't even really your uncle. Something like a father of a cousin of an in-law. A guy you mostly met at reunions at his house when you were a kid, the guy with the family that hates you.

I beg your pardon?

>n
Newroom
s

>shit
That's not a verb I recognise.

>jump
You jump on the spot.

>x self
As good-looking as ever.

>x differentthing
It's different.

>wait
Time passes.

>wait
Time passes.

> take Differentthing
You stuff it in your pocket as surreptitiously as you can.

>s
Foyer
The foyer of your uncle's home.

You can see John here.

* * *

>[enter]
He wasn't even really your uncle. Something like a father of a cousin of an in-law. A guy you mostly met at reunions at his house when you were a kid, the guy with the family that hates you.

>go e
You open the door.

>[enter]
It's absolutely full of coats.

>[enter]
You close the door.

* * *

>[enter]
He wasn't even really your uncle. Something like a father of a cousin of an in-law. A guy you mostly met at reunions at his house when you were a kid, the guy with the family that hates you.

>s
Not until you get what you came for.

* * *

>[enter]
He wasn't even really your uncle. Something like a father of a cousin of an in-law. A guy you mostly met at reunions at his house when you were a kid, the guy with the family that hates you.

>x umbrella
Shabby, old, a faded shade of purpleӒit's as weathered as the umbrella stand.

Okay, to be fair, that's kind of expected for an umbrella.

>x umbrella
Shabby, old, a faded shade of purple.

* * *

>[enter]
He wasn't even really your uncle. Something like a father of a cousin of an in-law. A guy you mostly met at reunions at his house when you were a kid, the guy with the family that hates you.

>read condolence book
Not to sound crass, but do the bereaved ever actually read these? It's bad enough having people come up to you in person to give a tactless "he's in a better place now", you can't imagine having a written record of that too.

You're not going to read it.

>wait
Time passes.

>wait
Time passes.

> take pen
You stuff it in your pocket as surreptitiously as you can.

>look
Vestibule
The entranceway of Uncle Clifton's imposing mansion. On your left, a weathered wooden umbrella stand sits, one lonely umbrella inside it.  Next to it, a table has been set up for the condolence book, which lies open.

You can see a table here.

>wait
Time passes.

>wait
Time passes.

> take condolence book
You stuff it in your pocket as surreptitiously as you can.

>look
Vestibule
The entranceway of Uncle Clifton's imposing mansion. On your left, a weathered wooden umbrella stand sits, one lonely umbrella inside it.  Next to it, a table has been set up for the condolence book, which is missing.

You can see a table here.

* * *

>[enter]
He wasn't even really your uncle. Something like a father of a cousin of an in-law. A guy you mostly met at reunions at his house when you were a kid, the guy with the family that hates you.

>m
That's not a verb I recognise.

>n
Hall
s

* * *

>[enter]
He wasn't even really your uncle. Something like a father of a cousin of an in-law. A guy you mostly met at reunions at his house when you were a kid, the guy with the family that hates you.

>take table
Against your will, you've gotten pretty good at taking things unnoticed. This, however, would attract attention, no matter how sneaky you are.

* * *

>[enter]
He wasn't even really your uncle. Something like a father of a cousin of an in-law. A guy you mostly met at reunions at his house when you were a kid, the guy with the family that hates you.

>take umbrella
This is a funeral reception and everyone knows you're a kleptomaniac. You're not going to intentionally take anything you aren't supposed to.

>take umbrella stand
Against your will, you've gotten pretty good at taking things unnoticed. This, however, would attract attention, no matter how sneaky you are.

>s
You're not leaving until you get what you came for.

Hell, with your condition you usually end up being escorted out another door.

>s
You're not leaving until you get what you came for.

* * *

>[enter]
He wasn't even really your uncle. Something like a father of a cousin of an in-law. A guy you mostly met at reunions at his house when you were a kid, the guy with the family that hates you.

>i
You are carrying:
  Cartwright's wallet

* * *

>[enter]
He wasn't even really your uncle. Something like a father of a cousin of an in-law. A guy you mostly met at reunions at his house when you were a kid, the guy with the family that hates you.

>se
You can't go that way.

>x library door
You can't see any such thing.

>n
Hall
s

You can see Cartwright here.

>x library door
You can't see any such thing.

>x door to library
You can't see any such thing.

>look
Hall
s

You can see Cartwright here.

>open door
You can't see any such thing.

>se
You can't go that way.

* * *

>[enter]
He wasn't even really your uncle. Something like a father of a cousin of an in-law. A guy you mostly met at reunions at his house when you were a kid, the guy with the family that hates you.

>examine umbrella stand
The umbrella stand is empty.

>look
Vestibule
The entranceway of Uncle Clifton's imposing mansion, the anteroom to the Hall to the north. On your left, a weathered wooden umbrella stand sits, one lonely umbrella inside it.  Next to it, a table has been set up for the condolence book, which lies open, and a pen.

* * *

>[enter]
He wasn't even really your uncle. Something like a father of a cousin of an in-law. A guy you mostly met at reunions at his house when you were a kid, the guy with the family that hates you.

>x umbrella stand
The weathered wooden umbrella stand has an old forgotten umbrella in it.

>wait
Time passes.

* * *

>wait
Time passes.

> take pen
You stuff it in your pocket as surreptitiously as you can.

>wait
Time passes.

>look
Vestibule
The entranceway of Uncle Clifton's imposing mansion, the anteroom to the Hall to the north. On your left, a weathered wooden umbrella stand sits, one lonely umbrella inside it.  Next to it, a table has been set up for the condolence book, which lies open.

>wait
Time passes.

* * *

>wait
Time passes.

> take condolence book
You stuff it in your pocket as surreptitiously as you can.

>look
Vestibule
The entranceway of Uncle Clifton's imposing mansion, the anteroom to the Hall to the north. On your left, a weathered wooden umbrella stand sits, one lonely umbrella inside it.  Next to it, a table has been set up for the condolence book, which is missing.

>wait
Time passes.

* * *

>wait
Time passes.

> take umbrella
You stuff it in your pocket as surreptitiously as you can.

>look
Vestibule
The entranceway of Uncle Clifton's imposing mansion, the anteroom to the Hall to the north. On your left, a weathered wooden umbrella stand sits.  Next to it, a table has been set up for the condolence book, which is missing.

>x umbrella stand
The weathered wooden umbrella stand is umbrellaless.

* * *

>[enter]
He wasn't even really your uncle. Something like a father of a cousin of an in-law. A guy you mostly met at reunions at his house when you were a kid, the guy with the family that hates you.

>go north
Hall
s

You can see Cartwright here.

>go north
Bathroom
A small but opulent bathroom. The only exit is back into the hall.

>open lotion
You would love to open this soothing lotion but you can't seem to get it open.

>examine sunglasses
Dark aviator sunglasses. Goes well with a cowboy hat.

>put on aviator sunglasses
You can't see any such thing.

* * *

>go north
Bathroom
A small but opulent bathroom. The only exit is back into the hall.

>examine scarg
You can't see any such thing.

>examine scarf
""It's truly truly outrageous
truly truly truly outrageous.""

-Jem and The Holograms, "Truly Outrageous".

* * *

>[enter]
He wasn't even really your uncle. Something like a father of a cousin of an in-law. A guy you mostly met at reunions at his house when you were a kid, the guy with the family that hates you.

>[enter]
He ran a real estate company. Made millions off the backs of his employees and the people who lived in his properties. You don't get the kind of money he had by being a good person.

>[enter]
He was awful, probably.

>[enter]
He was one of the few people who bothered to understand you.

>[enter]
He caught you once, in your teens, stealing his silver pocketwatch from on top of his desk. He didn't get mad. He'd figured it out, before anyone else. You had kleptomania. An uncontrollable compulsion.

He gently took the pocketwatch back and promised you that someday, when he was gone, it would be yours.

>[enter]
He caught you once, in your teens, stealing his silver pocketwatch from on top of his desk. He didn't get mad. He'd figured it out, before anyone else. You had kleptomania. An uncontrollable compulsion.

>[enter]
He gently took the pocketwatch back and promised you that someday, when he was gone, it would be yours.

>[enter]
That's why you're sitting in your car in front of his house, trying to convince yourself to brave the funeral reception so you can sneak upstairs, take the nicest present anyone's ever given you, and finally say goodbye to his family for good.

>[enter]
You get out of the car, nervously walk up to the front door, open it, and run smack dab into Cartwright.

He gives you a dirty look and walks off into the hall.

>[enter]
His wallet fell out of his pocket. It's sitting on the floor.

>[enter]
> take wallet
You stuff it in your pocket as surreptitiously as you can.

>n
Hall
The hall connest you to the rest of the house. There are six doors leading out of the hall and a stairwell leading up to the second floor.

To the southwest is the sitting room.
To the northwest is the kitchen.
To the north is the bathroom.
To the northeast is the game room.
To the southeast is the library.
To the south is the vestibule.

You can see Cartwright here.

>sw
Sitting Room
A crowd of family and friends share condolences and fond memories of Uncle Clifton, drink champagne, and eat the hors d'oeuvres that remain on their napkins. Dimia sits in the middle of it all, looking past you, a hard-to-read expression on her face. The couch is loaded down with stuff: a pack of cigarettes and its ashtray, balanced precariously; a clutch; a cardigan and a leather jacket, draped over the couch next to each other; an empty china plate; and a golden watch. A chess set sits to the side of the room, on a game table, and a forgotten champagne flute sits on top of it.

To the west, a door is open to the lawn, where the remaining hors d'oeuvres are laid out. Barely anyone's out there.

>x family
They pass around anecdotes

>w
Lawn
Description of lawn. Hors d'oeuvres, also a person who isn't a jerk about your condition

>give wallet to hildegard
Hildegard grins, taking the wallet.

She leans in conspiratorially. "Go back to the hall, and I'll yell to Cartwright that I found his wallet."

>e
Sitting Room
A crowd of family and friends share condolences and fond memories of Uncle Clifton, drink champagne, and eat the hors d'oeuvres that remain on their napkins. Dimia sits in the middle of it all, looking past you, a hard-to-read expression on her face. The couch is loaded down with stuff: a pack of cigarettes and its ashtray, balanced precariously; a clutch; a cardigan and a leather jacket, draped over the couch next to each other; an empty china plate; and a golden watch. A chess set sits to the side of the room, on a game table, and a forgotten champagne flute sits on top of it.

To the west, a door is open to the lawn, where the remaining hors d'oeuvres are laid out. Barely anyone's out there.

>ne
Hall
The hall connest you to the rest of the house. There are six doors leading out of the hall and a stairwell leading up to the second floor.

To the southwest is the sitting room.
To the northwest is the kitchen.
To the north is the bathroom.
To the northeast is the game room.
To the southeast is the library.
To the south is the vestibule.

You can see Cartwright here.

A muffled cry from the other room:

"Cartwright! I found your wallet!"

>[enter]
Cartwright gives you a funny look before begrudgingly leaving his post by the stairs and heading into the sitting room.

"You found my wallet?"

>[enter]
Now's your chance! You duck up the stairs and tiptoe over to Uncle Clifton's study.

Uncle Clifton's Study
Your fingers itch.

* * *

>w
Lawn
Description of lawn. Hors d'oeuvres, also a person who isn't a jerk about your condition

* * *

>[enter]
Cartwright gives you a funny look before begrudgingly leaving his post by the stairs and heading into the sitting room.

"You found my wallet?"

>[enter]
Now's your chance! You duck up the stairs and tiptoe over to Uncle Clifton's study.

Uncle Clifton's Study

>hit
What do you want to hit?

>self
Violence isn't the answer to this one.

* * *

>[enter]
> take wallet
You stuff it in your pocket as surreptitiously as you can.

>[enter]
In about a seven count, you're going to take something else, even though you don't want to.

>[enter]
You can kind of understand why Uncle Clifton's family don't like you.

you can't take it with you
a take all game by take all games
Release 2 / Serial number 200726 / Inform 7 build 6M62 (I6/v6.33 lib 6/12N) SD
Type HELP for more information.

Vestibule
The entranceway of Uncle Clifton's imposing mansion, the anteroom of the Hall to the north. On your left, a weathered wooden umbrella stand sits, one lonely umbrella inside it. Next to it, a table has been set up for the condolence book, which lies open, and a pen.

>n
Hall
This great hall connects you to the rest of the house. To the southwest is the sitting room, where most of the family is. To the northwest, the kitchen. To the north is the bathroom, to the northeast the game room, the southeast, the library, and the south, where you just came from, is the vestibule. Near the bathroom, a stairway leads up to the second floor. Cartwright stands guard in front of it. Next to him, a hunting trophy also stands guard.

Cedric and Bryce whisper about something. You can only make out the words "alter" and "will".

When they see you, they quickly move to the game room.

>sw
Sitting Room
A crowd of family and friends share condolences and fond memories of Uncle Clifton, drink champagne, and eat the hors d'oeuvres that remain on their napkins. Dimia sits in the middle of it all, looking past you, a hard-to-read expression on her face. The couch is loaded down with stuff: a pack of cigarettes and its ashtray, balanced precariously; a clutch; a cardigan and a leather jacket, draped over the couch next to each other; an empty china plate; and a golden watch. A chess set sits to the side of the room, on a game table, and a forgotten champagne flute sits on top of it.

To the west, a door is open to the lawn, where the remaining hors d'oeuvres are laid out. Barely anyone's out there.

>w
Lawn
A clearing full of lush green grass. A table is set up with, at this point, just peanut butter canapés. Standing near the table is Hildegard, a rare friendly face.

>give wallet to hildegard
Hildegard grins, taking the wallet.

She leans in conspiratorially. "Go back to the hall, and I'll yell to Cartwright that I found his wallet."

>e
Sitting Room
A crowd of family and friends share condolences and fond memories of Uncle Clifton, drink champagne, and eat the hors d'oeuvres that remain on their napkins. Dimia sits in the middle of it all, looking past you, a hard-to-read expression on her face. The couch is loaded down with stuff: a pack of cigarettes and its ashtray, balanced precariously; a clutch; a cardigan and a leather jacket, draped over the couch next to each other; an empty china plate; and a golden watch. A chess set sits to the side of the room, on a game table, and a forgotten champagne flute sits on top of it.

To the west, a door is open to the lawn, where the remaining hors d'oeuvres are laid out. Hildegarde is out there.

>ne
Hall
This great hall connects you to the rest of the house. To the southwest is the sitting room, where most of the family is. To the northwest, the kitchen. To the north is the bathroom, to the northeast the game room, the southeast, the library, and the south is the vestibule. Near the bathroom, a stairway leads up to the second floor. Cartwright stands guard in front of it. Next to him, a hunting trophy also stands guard.

A muffled cry from the other room:

"Cartwright! I found your wallet!"

>[enter]
Cartwright gives you a funny look before begrudgingly leaving his post by the stairs and heading into the sitting room.

"You found my wallet?"

>[enter]
Now's your chance! You duck up the stairs and tiptoe over to Uncle Clifton's study.

Uncle Clifton's Study
You know this room very well, but you're so focused on one thing you can barely notice the partners desk it's sitting on, or the papers it's sitting on top of:

The silver pocketwatch.

>x papers
Some stacks of papers. It doesn't matter what they are. All that matters right now is the watch.

>x desk
It's a desk. You're more interested right now with what's on it.

>x letter opener
You can't see any such thing.

>take pocketwatch
You grab the pocketwatch, not in an act of compulsive theft, but as a statement of ownership.

>[enter]
You take a moment of silence, to remember Uncle Clifton by. The only sound is the muffled ticking of his pocketwatch in your pocket.

>look
Uncle Clifton's Study
You know this room very well. The partners desk, given pride of place in the center of the room. The rolling chair behind it. The letter opener on the desk.

On the partners desk is a letter opener.

>pick up will
You can't see any such thing.

>x original will
You can't see any such thing.

* * *

>[enter]
You take a moment of silence, to remember Uncle Clifton by. The only sound is the muffled ticking of his pocketwatch in your pocket.

>[enter]
With the moment of silence over, now you can leave this damn house.

Uncle Clifton's Study
You know this room very well. The partners desk, given pride of place in the center of the room. The rolling chair behind it. 

Now that you're not singularly focused on the pocketwatch, you can see that the papers under it were...Uncle Clifton's will, and a will that looks almost just like it.

>look
Uncle Clifton's Study
You know this room very well. The partners desk, given pride of place in the center of the room. The rolling chair behind it. The letter opener on the desk.

On the partners desk is a letter opener.

>x will
You can't see any such thing.

* * *

>look
Uncle Clifton's Study
You know this room very well. The partners desk, given pride of place in the center of the room. The rolling chair behind it. The letter opener on the desk.

On the partners desk is a letter opener.

>take will
You can't see any such thing.

>x will
You can't see any such thing.

* * *

>[enter]
With the moment of silence over, now you can leave this damn house.

Uncle Clifton's Study
You know this room very well. The partners desk, given pride of place in the center of the room. The rolling chair behind it. 

Now that you're not singularly focused on the pocketwatch, you can see that the papers under it were...Uncle Clifton's will, and a will that looks almost just like it.

>x will
Which do you mean, the doctored will or the original will?

>original
You pick up both wills, one in each hand, weighing the implications.

>[enter]
One will is definitely the original. The other is a decent fake.

>[enter]
You read through the wills at the same time. You can only find one change in the doctored will.

>[enter]
The line that bequeaths the pocketwatch to you has been removed.

>[enter]
His family gets a 750 fucking million dollar estate and they couldn't let you have one measly pocketwatch.

>[enter]
You sigh.

>[enter]
You hear the unmistakable cli-cli-click of a revolver hammer being pulled back.

Uncle Clifton's Study
There's a rolling chair, a desk

Oh also, Cartwright is standing in the doorway, brandishing a six-shooter at you.

Cartwright tells you how much he hates you, as if the gun wasn't an obvious reminder.

>wait
Time passes.

2

>wait
Time passes.

3

>wait
Time passes.

4

>wait
Time passes.

5

>wait
Time passes.

6

>wait
Time passes.

7
> take revolver
You stuff it in your pocket as surreptitiously as you can.

>[enter]
Wait.

>[enter]
What?

>[enter]
You find yourself holding Cartwright at gunpoint. Waving the revolver in the direction of the desk chair.
Your body moves without you, sprinting out of the room towards the stairsFuck this family.
You're taking everything that isn't nailed down.

* * *

>[enter]
You hear the unmistakable cli-cli-click of a revolver hammer being pulled back.

Uncle Clifton's Study
There's a rolling chair, a desk

Oh also, Cartwright is standing in the doorway, brandishing a six-shooter at you.

Cartwright tells you how much he hates you, as if the gun wasn't an obvious reminder.

>attack cartwright
Violence isn't the answer to this one, but it should be. The problem is that this is a gun fight, and you haven't brought a gun.

>[enter]
Cartwright did.

>[enter]
*** You have died ***

Would you like to RESTART, RESTORE a saved game, QUIT or UNDO the last command?

>undo
Uncle Clifton's Study
[Previous turn undone.]

>take letter opener
Cartwright sees you reaching for the knife, and fires.

>[enter]
Maybe you shouldn't have brought a knife to a gun fight.

>[enter]
*** You have died ***

Would you like to RESTART, RESTORE a saved game, QUIT or UNDO the last command?

* * *

>[enter]
You hear the unmistakable cli-cli-click of a revolver hammer being pulled back.

Uncle Clifton's Study
There's a rolling chair, a desk

Oh also, Cartwright is standing in the doorway, brandishing a six-shooter at you.

Cartwright tells you how much he hates you, as if the gun wasn't an obvious reminder.

>give canape to cartwright
You can't see any such thing.

* * *

>x will
Which do you mean, the doctored will or the original will?

>doctored
You pick up both wills, one in each hand, weighing the implications.

>[enter]
One will is definitely the original. The other is a decent fake.

* * *

>[enter]
You hear the unmistakable cli-cli-click of a revolver hammer being pulled back.

Uncle Clifton's Study
There's a rolling chair, a desk

Oh also, Cartwright is standing in the doorway, brandishing a six-shooter at you.

Cartwright tells you how much he hates you, as if the gun wasn't an obvious reminder.

>throw canape at cartwright
You can't see any such thing.

>i
You are carrying:
  a doctored will
  an original will
  a silver pocketwatch
  a church pew pencils
  a hymnal

Cartwright uses the arm that isn't holding the gun to wipe sweat off his brow.

>give pocketwatch to cartwright
It's what he wants, but 1. you get the sense that any false moves will send you to the same place as Uncle Clifton, and 2. you're taking this damn watch with you.

You wish he'd point that gun somewhere else.

>wait
Time passes.

You've gotta think of a way out of this.

>wait
Time passes.

Cartwright makes a snide remark about your kleptomania.

>wait
Time passes.

You need a miracle.

>wait
Time passes.

Cartwright brags about how good he is on the shooting range.

> take revolver
You stuff it in your pocket as surreptitiously as you can.

>[enter]
Wait.

* * *

>[enter]
What?

>[enter]
You find yourself holding Cartwright at gunpoint. Waving the revolver in the direction of the desk chair until the scared bully sits down.

>[enter]
Your body moves without you, sprinting out of the room towards the stairs

>[enter]
Fuck this family.

>[enter]
You're taking everything that isn't nailed down.

You run back the way you came, barrelling down the stairs.

>[enter]
You hear Cartwright yell "THIEF!" and, after a moment's thought, "WITH A GUN!"

>[enter]
You see Edmund charging you.

>[enter]
You duck into the kitchen.

Kitchen
The caterers sprint out of the room, because you're sprinting into it with a gun. Rowan freezes, a handful of ham in his hand. Then he bolts as well. Here's a list of everything you can steal from the kitchen now: .

Take all of it!

>i
You are carrying:
  a revolver
  a doctored will
  an original will
  a silver pocketwatch
  a church pew pencils
  a hymnal

>take grapes
Taken.

Edmund finally catches up to you.

>[enter]
You dodge him and run into the dining room.

Dining Room
The caterers have already fled. On her way out of the room, Anne flashes you a dirty look.

Anyways, there's more things to steal: the delicate tea cup, the empty bottle and the recipe book.

Take everything!

>take recipe boox
You can't see any such thing.

>take recipe book
You can't see any such thing.

>take tea cup
You can't see any such thing.

>take bottle
You can't see any such thing.

>x bottle
You can't see any such thing.

>x china
A tall wooden cabinet. Through the glass panels in the cabinet doors, you can see an absurdly expensive collection of fancy, mostly unused fine china.

>take china
Against your will, you've gotten pretty good at taking things unnoticed. This, however, would attract attention, no matter how sneaky you are. Your compulsion will figure out something else to take, when the time comes.

Edmund catches up to you again, but the new, slippery loafers he's wearing finally get the best of him, and he faceplants into the dining room floor.

You run into the sitting room with extra time to spare.

Sitting Room
This room was crowded just a few minutes ago. It seems like the people who were in here took the door to the hall and then barricaded it. Cool.

Anyways, it's time to steal: the Dane's placecard, the Anne's placecard, the Rowan's placecard, the Hildegard's placecard, the Dimia's placecard, the Beatrix's placecard, the Bryce's placecard, the Cartwright's placecard, the Cedric's placecard and the Edmund's placecard. Take it all.

>take champagne flute
Taken.

>z
Time passes.

>z
Time passes.

Probably best to quit while you're ahead.

>[enter]
Lawn
You run out onto the lawn. Hildegard gives you a high five.

>[enter]
You jump in your car. You speed off into the sunset, your silver pocketwatch in one hand and a goofy smile on your face.

    *** The End ***

Would you like to RESTART, RESTORE a saved game, QUIT or UNDO the last command?

* * *

>[enter]
With the moment of silence over, now you can leave this damn house.

Uncle Clifton's Study
You know this room very well. The partners desk, given pride of place in the center of the room. The rolling chair behind it. 

Now that you're not singularly focused on the pocketwatch, you can see that the papers under it were...Uncle Clifton's will, and a will that looks almost just like it.

>take will
Which do you mean, the doctored will or the original will?

>doctored
You pick up both wills, one in each hand, weighing the implications.

* * *

>[enter]
The line that bequeaths the pocketwatch to you has been removed.

>[enter]
A 750 fucking million dollar estate and they couldn't let you have one measly pocketwatch.

>[enter]
You sigh.

>[enter]
You hear the unmistakable sound of a revolver hammer being pulled back.

* * *

>[enter]
Now's your chance! You duck up the stairs and tiptoe over to Uncle Clifton's study.

Uncle Clifton's Study
You know this room very well, but you're so focused on one thing you can barely notice the partners desk it's sitting on, or the papers it's sitting on top of:

The silver pocketwatch.

>x desk
It's a desk. You're more interested right now with what's on it.

>x papers
Some stacks of papers. It doesn't matter what they are. All that matters right now is the watch.

>x watch
You can't see any such thing.

>x pocketwatch
The one thing Uncle Clifton promised to you. It's beautiful. On the inside, the hour and minute hand point at roman numerals. On the outside, gold accents circumscribe a pair of initials, also in gold: C.F.

Either Uncle Clifton commissioned this watch, or he got very lucky in an antique shop.

>take pocketwatch
You grab the pocketwatch, not in an act of compulsive theft, but as a statement of ownership.

* * *

>[enter]
You take a moment of silence, to remember Uncle Clifton by. The only sound is the muffled ticking of his pocketwatch in your pocket.

>[enter]
With the moment of silence over, now you can leave this damn house.

Uncle Clifton's Study
You know this room very well. The partners desk, given pride of place in the center of the room. The rolling chair behind it. The letter opener on the desk.

Now that you're not singularly focused on the pocketwatch, you can see that the papers under it were...Uncle Clifton's will, and a will that looks almost just like it.

On the partners desk is a letter opener.

>take rolling chair
Against your will, you've gotten pretty good at taking things unnoticed. This, however, would attract attention, no matter how sneaky you are. Your compulsion will figure out something else to take, when the time comes.

>take will
Which do you mean, the doctored will or the original will?

>original
You pick up both wills, one in each hand, weighing the implications.

* * *

>[enter]
You sigh.

>[enter]
You hear the unmistakable cli-cli-click of a revolver hammer being pulled back.

Uncle Clifton's Study
There's a rolling chair, a desk

Oh also, Cartwright is standing in the doorway, brandishing a six-shooter at you.

On the partners desk is a letter opener.

You can also see Cartwright here.

Cartwright tells you how much he hates you, as if the gun wasn't an obvious reminder.

>i
You are carrying:
  a doctored will
  an original will
  a silver pocketwatch
  Church pew pencils
  Hymnal

Cartwright uses the arm that isn't holding the gun to wipe sweat off his brow.

>take knife
You can't see any such thing.

>take letter opener
Cartwright sees you reaching for the knife, and fires.

* * *

>undo
Uncle Clifton's Study
[Previous turn undone.]

>wait
Time passes.

You wish he'd point that gun somewhere else.

>x gun
You can't see any such thing.

>x revolver
You really don't want to be on the wrong end of this.

You've gotta think of a way out of this.

>look
Uncle Clifton's Study
There's a rolling chair, a desk

Oh also, Cartwright is standing in the doorway, brandishing a six-shooter at you.

On the partners desk is a letter opener.

You can also see Cartwright here.

Cartwright makes a snide remark about your kleptomania.

* * *

>w
Lawn
A clearing full of lush green grass. A table is set up with, at this point, just peanut butter canapés. Standing near the table is Hildegard, a rare friendly face.

>take peanut butter canape
Hey, it's not stealing if it's free food.

Taken.

>wait
Time passes.

* * *

>wait
Time passes.

Your fingers itch.

>e
Sitting Room
A crowd of family and friends share condolences and fond memories of Uncle Clifton, drink champagne, and eat the hors d'oeuvres that remain on their napkins. Dimia sits in the middle of it all, looking past you, a hard-to-read expression on her face. The couch is loaded down with stuff: a pack of cigarettes and its ashtray, balanced precariously; a clutch; a cardigan and a leather jacket, draped over the couch next to each other; an empty china plate; and a golden watch. A chess set sits to the side of the room, on a game table, and a forgotten champagne flute sits on top of it.

To the west, a door is open to the lawn, where the remaining hors d'oeuvres are laid out. Barely anyone's out there.

* * *

>take peanut butter canape
Hey, it's not stealing if it's free food.

Taken.

>give wallet to hildegard
Hildegard grins, taking the wallet.

She leans in conspiratorially. "Go back to the hall, and I'll yell to Cartwright that I found his wallet."

>wait
Time passes.

>wait'
That's not a verb I recognise.

>e
Sitting Room
A crowd of family and friends share condolences and fond memories of Uncle Clifton, drink champagne, and eat the hors d'oeuvres that remain on their napkins. Dimia sits in the middle of it all, looking past you, a hard-to-read expression on her face. The couch is loaded down with stuff: a pack of cigarettes and its ashtray, balanced precariously; a clutch; a cardigan and a leather jacket, draped over the couch next to each other; an empty china plate; and a golden watch. A chess set sits to the side of the room, on a game table, and a forgotten champagne flute sits on top of it.

To the west, a door is open to the lawn, where the remaining hors d'oeuvres are laid out. Hildegarde is out there.

* * *

>[enter]
Now's your chance! You duck up the stairs and tiptoe over to Uncle Clifton's study.

Uncle Clifton's Study
You know this room very well, but you're so focused on one thing you can barely notice the partners desk it's sitting on, or the papers it's sitting on top of:

The silver pocketwatch.

>take watch
You grab the pocketwatch, not in an act of compulsive theft, but as a statement of ownership.

>[enter]
You take a moment of silence, to remember Uncle Clifton by.

>[enter]
The only sound is the muffled ticking of his pocketwatch in your pocket.

>x letter opener
With the moment of silence over, now you can leave this damn house.

Uncle Clifton's Study
You know this room very well. The partners desk, given pride of place in the center of the room. The rolling chair behind it. The letter opener on the desk.

Now that you're not singularly focused on the pocketwatch, you can see that the papers under it were...Uncle Clifton's will, and a will that looks almost just like it.

>take letter opener
Taken.

>take will
Which do you mean, the doctored will or the original will?

* * *

>[enter]
You sigh.

>[enter]
You hear the unmistakable cli-cli-click of a revolver hammer being pulled back.

Uncle Clifton's Study
There's a rolling chair, and a desk.

Oh also, Cartwright is standing in the doorway, brandishing a six-shooter at you.

Cartwright tells you how much he hates you, as if the gun wasn't an obvious reminder.

>stab cartwright
Violence isn't the answer to this one, but it should be. The problem is that this is a gun fight, and you haven't brought a gun.

>hit cartwright
Violence isn't the answer to this one, but it should be. The problem is that this is a gun fight, and you haven't brought a gun.

>[enter]
Cartwright did.

* * *

>undo
Uncle Clifton's Study
[Previous turn undone.]

>take gun
That seems to belong to Cartwright.

Cartwright uses the arm that isn't holding the gun to wipe sweat off his brow.

>throw canape at cartwright
Cartwright's deathly allergic, but he's also a quick shot.

>[enter]
Seriously, who brings a canapé to a gunfight?

>[enter]
*** Cartwright has died, but so have you ***

Would you like to RESTART, RESTORE a saved game, QUIT or UNDO the last command?

>undo
Uncle Clifton's Study
[Previous turn undone.]

>throw knife at cartwright
You lack the nerve when it comes to the crucial moment.

You wish he'd point that gun somewhere else.

>take letter opener
Cartwright sees you reaching for the knife, and fires.

* * *

>undo
Uncle Clifton's Study
[Previous turn undone.]

>give canape to cartwright
Cartwright's deathly allergic, but he shoots you before you get close.

>[enter]
Seriously, who brings a canapé to a gunfight?

>[enter]
*** You have died ***

Would you like to RESTART, RESTORE a saved game, QUIT or UNDO the last command?

* * *

>undo
Uncle Clifton's Study
[Previous turn undone.]

>give pocketwatch to cartwright
It's what he wants, but 1. you get the sense that any false moves will send you to the same place as Uncle Clifton, and 2. you're taking this damn watch with you.

You've gotta think of a way out of this.

>take chair
Against your will, you've gotten pretty good at taking things unnoticed. This, however, would attract attention, no matter how sneaky you are. Your compulsion will figure out something else to take, when the time comes.

Cartwright makes a snide remark about your kleptomania.

>x cartwright
You ever been in the same room as one of those rich fratty white guys? You know the type. Dominates every conversation with hurtful, overpersonal "jokes" at the expense of his buddies, but as soon as they turn it back on him, he gets real quiet and real tense and everyone kind of changes the subject?

Yeah, Cartwright is that guy as an old man.

Towering, gray-haired. You think he's Uncle Clifton's brother? Maybe his cousin. Either way, his stature and his demeanor have the effect of making him intimidating, an effect which is only slightly diminished by your vague recollection that he is mildly allergic to a comical amount of things.

He seems annoyed with you. It might be because you stole his wallet.

You need a miracle.

>x self
As good-looking as ever.

Cartwright brags about how good he is on the shooting range.

> take revolver
You stuff it in your pocket as surreptitiously as you can.

>[enter]
Wait.

* * *

>stab cartwright
Violence isn't the answer to this one, but it should be. The problem is that this is a gun fight, and you haven't brought a gun.

>[enter]
Cartwright did.

* * *

>[enter]
You hear the unmistakable cli-cli-click of a revolver hammer being pulled back.

Uncle Clifton's Study
There's a rolling chair, and a desk.

Oh also, Cartwright is standing in the doorway, brandishing a six-shooter at you.

Cartwright tells you how much he hates you, as if the gun wasn't an obvious reminder.

>x cartwright
You know those old rich fratty white guys who hold people at gunpoint?

Yeah. Exactly.

Cartwright uses the arm that isn't holding the gun to wipe sweat off his brow.

>throw knife at cartwright
You lack the nerve when it comes to the crucial moment.

You wish he'd point that gun somewhere else.

>stab cartwright
That's not a verb I recognise.

>attack cartwright
Violence isn't the answer to this one, but it should be. The problem is that this is a gun fight, and you haven't brought a gun.

* * *

>undo
Uncle Clifton's Study
[Previous turn undone.]

>take gun
That seems to belong to Cartwright.

You've gotta think of a way out of this.

* * *

>x letter opener
With the moment of silence over, now you can leave this damn house.

Uncle Clifton's Study
You know this room very well. The partners desk, given pride of place in the center of the room. The rolling chair behind it. The letter opener on the desk.

Now that you're not singularly focused on the pocketwatch, you can see that the papers under it were...Uncle Clifton's will, and a will that looks almost just like it.

>take will
Which do you mean, the doctored will or the original will?

>both
doctored will: original will: You pick up both wills, one in each hand, weighing the implications.

>[enter]
One will is definitely the original. The other is a decent fake.

* * *

>[enter]
You sigh.

>[enter]
You hear the unmistakable cli-cli-click of a revolver hammer being pulled back.

Uncle Clifton's Study
There's a rolling chair, a desk, and a letter opener.

Oh also, Cartwright is standing in the doorway, brandishing a six-shooter at you.

Cartwright tells you how much he hates you, as if the gun wasn't an obvious reminder.

>stab cartwright
Cartwright sees you reaching for the letter opener, and fires.

>[enter]
Maybe you shouldn't have brought a knife to a gun fight.

* * *

>stab cartwright
Cartwright sees you reaching for the letter opener, and fires.

>u
Maybe you shouldn't have brought a knife to a gun fight.

>n
*** You have died ***

Would you like to RESTART, RESTORE a saved game, QUIT or UNDO the last command?

* * *

>[enter]
You hear the unmistakable cli-cli-click of a revolver hammer being pulled back.

Uncle Clifton's Study
There's a rolling chair, a desk, and a letter opener.

Oh also, Cartwright is standing in the doorway, brandishing a six-shooter at you.

Cartwright tells you how much he hates you, as if the gun wasn't an obvious reminder.

>take letter opener
Cartwright sees you reaching for the knife, and fires.

* * *

>undo
Uncle Clifton's Study
[Previous turn undone.]

>stab cartwright
Cartwright sees you reaching for the knife, and fires.

>[enter]
Maybe you shouldn't have brought a knife to a gun fight.

* * *

>w
Lawn
A clearing full of lush green grass. A table is set up with, at this point, just peanut butter canapés. Standing near the table is Hildegard, a rare friendly face.

>wait
Time passes.

>it
That's not a verb I recognise.

>wait
Time passes.

* * *

>wait
Time passes.

Your fingers itch.

>e
Sitting Room
A crowd of family and friends share condolences and fond memories of Uncle Clifton, drink champagne, and eat the hors d'oeuvres that remain on their napkins. Dimia sits in the middle of it all, looking past you, a hard-to-read expression on her face. The couch is loaded down with stuff: a pack of cigarettes and its ashtray, balanced precariously; a clutch; a cardigan and a leather jacket, draped over the couch next to each other; an empty china plate; and a golden watch. A chess set sits to the side of the room, on a game table, and a forgotten champagne flute sits on top of it.

To the west, a door is open to the lawn, where the remaining hors d'oeuvres are laid out. Hildegarde is out there.

>ne
Hall
This great hall connects you to the rest of the house. To the southwest is the sitting room, where most of the family is. To the northwest, the kitchen. To the north is the bathroom, to the northeast the game room, the southeast, the library, and the south, is the vestibule. Near the bathroom, a stairway leads up to the second floor. Cartwright stands guard in front of it.

>give canape to cartwright
You can't see any such thing.

* * *

>w
Lawn
A clearing full of lush green grass. A table is set up with, at this point, just peanut butter canapés. Standing near the table is Hildegard, a rare friendly face.

>take canape
Hey, it's not stealing if it's free food.

Taken.

>take canape
Hey, it's not stealing if it's free food.

You already have that.

>wait
Time passes.

* * *

>ne
Hall
This great hall connects you to the rest of the house. To the southwest is the sitting room, where most of the family is. To the northwest, the kitchen. To the north is the bathroom, to the northeast the game room, the southeast, the library, and the south is the vestibule. Near the bathroom, a stairway leads up to the second floor. Cartwright stands guard in front of it. Next to him, a hunting trophy also stands guard.

>give canape to cartwright
In order to get past him, you give Cartwright--a man whose allergies might be way more severe than you're aware of--a common and potentially life-threatening allergen.

>[enter]
No. You don't. Obviously you don't.

>[enter]
What is wrong with you?

>[enter]
Hall
This great hall connects you to the rest of the house. To the southwest is the sitting room, where most of the family is. To the northwest, the kitchen. To the north is the bathroom, to the northeast the game room, the southeast, the library, and the south is the vestibule. Near the bathroom, a stairway leads up to the second floor. Cartwright stands guard in front of it. Next to him, a hunting trophy also stands guard.

* * *

>take canape
Hey, it's not stealing if it's free food.

Taken.

>e
Sitting Room
A crowd of family and friends share condolences and fond memories of Uncle Clifton, drink champagne, and eat the hors d'oeuvres that remain on their napkins. Dimia sits in the middle of it all, looking past you, a hard-to-read expression on her face. The couch is loaded down with stuff: a pack of cigarettes and its ashtray, balanced precariously; a clutch; a cardigan and a leather jacket, draped over the couch next to each other; an empty china plate; and a golden watch. A chess set sits to the side of the room, on a game table, and a forgotten champagne flute sits on top of it.

To the west, a door is open to the lawn, where the remaining hors d'oeuvres are laid out. Hildegarde is out there.

* * *

>ne
Hall
This great hall connects you to the rest of the house. To the southwest is the sitting room, where most of the family is. To the northwest, the kitchen. To the north is the bathroom, to the northeast the game room, the southeast, the library, and the south is the vestibule. Near the bathroom, a stairway leads up to the second floor. Cartwright stands guard in front of it. Next to him, a hunting trophy also stands guard.

>wait
Time passes.

> take hunting trophy
You stuff it in your pocket as surreptitiously as you can.

>[enter]
You just can't help yourself, can you.

* * *

>wait
Time passes.

> take hunting trophy
You stuff it in your pocket as surreptitiously as you can.

>w
You just can't help yourself, can you.

>[enter]
"THIEF! THIEF!"

* * *

>n
Dining Room
There is a china cabinet in the corner and a long oaken dining table with a large centerpiece and ten placecards set around the table. 

There is no placecard for you. The kitchen is to the north. The sitting room is to the south.

Anne sits at the table with her head in her hands.

>x anne
Hildegarde's mom. She looks exhausted. She doesn't look thrilled to see you.

> take Rowan's placecard
You stuff it in your pocket as surreptitiously as you can.

>[enter]
You just can't help yourself, can you.

* * *

>[enter]
*** You have been thrown out ***

Would you like to RESTART, RESTORE a saved game, QUIT or UNDO the last command?

Please give one of the answers above.

Would you like to RESTART, RESTORE a saved game, QUIT or UNDO the last command?

* * *

>nw
Kitchen
The kitchen is mostly filled with a small militia of busy caterers. They bustle around not paying you any attention.

On the plus side they probably won't care if you take anything.

Unfortunately they are currently occupying three quarters of the room.

You can reach the pantry to the north of the kitchen or head into the dining room to the south. The counter you can reach holds a delicate tea cup, an empty bottle, a pocket-sized recipe book, and some loose grapes.

>wait
Time passes.

>wait
Time passes.

Rowan enters, searching for a snack.

>x rowan
He's a college rower, so he spends a lot of time in the kitchen searching for protein. He'll probably be in here a while.

* * *

>stab cartwright
Even if you had a knife, stabbing people out of nowhere is generally considered both "rude" and "attempted murder."

* * *

>[enter]
You can kind of understand why Uncle Clifton's family don't like you.

you can't take it with you
a take all game by take all games
Release 2 / Serial number 200726 / Inform 7 build 6M62 (I6/v6.33 lib 6/12N) SD
Type HELP for more information.

Vestibule
The entranceway of Uncle Clifton's imposing mansion, the anteroom of the Hall to the north. On your left, a weathered wooden umbrella stand sits, one lonely umbrella inside it. Next to it, a table has been set up for the condolence book, which lies open, and a pen.

>help
> Introduction to you can't take it with you
   Instructions for Play

>[enter]
hi! chloe from take all games here. cool to see you're playing our game.

you can't take it with you is a short comedy game about kleptomania with absolutely no deeper meaning at all. the previous sentence was a lie.

it was originally made for the GMTK game jam, july 2020. it is our first work as a team, onion and ian's first work of parser-based interactive fiction, my second, and the fourth work of interactive fiction in total that I have worked on.

credits:
chloe "tvwolfsnake" spears: writing, programming, coding
ironiconion: writing, programming, coding, cover art
ian kay: writing.

Please press SPACE to continue.

> Introduction to you can't take it with you
   Instructions for Play

 > Introduction to you can't take it with you
   Instructions for Play

>[enter]
hi! chloe from take all games here. cool to see you're playing our game.

you can't take it with you is a short comedy game about kleptomania with absolutely no deeper meaning at all. the previous sentence was a lie.

it was originally made for the GMTK game jam, july 2020. it is our first work as a team, onion and ian's first work of parser-based interactive fiction, my second, and the fourth work of interactive fiction in total that I have worked on.

credits:
chloe "tvwolfsnake" spears: writing, programming, coding
ironiconion: writing, programming, coding, cover art
ian kay: writing.

Please press SPACE to continue.

* * *

> Introduction to you can't take it with you
   Instructions for Play

 > Introduction to you can't take it with you
   Instructions for Play

hi! chloe from take all games here. cool to see you're playing our game.

you can't take it with you is a short comedy game about kleptomania with absolutely no deeper meaning at all. the previous sentence was a lie.

it was originally made for the GMTK game jam, july 2020. it is our first work as a team, onion and ian's first work of parser-based interactive fiction, my second, and the fourth work of interactive fiction in total that I have worked on.

credits:
chloe "tvwolfsnake" spears: writing, programming, coding
ironiconion: writing, programming, coding, cover art
ian kay: writing.

Please press SPACE to continue.

> Introduction to you can't take it with you
   Instructions for Play

 > Introduction to you can't take it with you
   Instructions for Play

* * *

> Introduction to you can't take it with you
   Instructions for Play

 > Introduction to you can't take it with you
   Instructions for Play

>[esc]
Vestibule
The entranceway of Uncle Clifton's imposing mansion, the anteroom of the Hall to the north. On your left, a weathered wooden umbrella stand sits, one lonely umbrella inside it. Next to it, a table has been set up for the condolence book, which lies open, and a pen.

>n
Hall
This great hall connects you to the rest of the house. To the southwest is the sitting room, where most of the family is. To the northwest, the kitchen. To the north is the bathroom, to the northeast the game room, the southeast, the library, and the south, where you just came from, is the vestibule. Near the bathroom, a stairway leads up to the second floor. Cartwright stands guard in front of it. Next to him, a hunting trophy also stands guard.

Cedric and Bryce whisper about something. You can only make out the words "alter" and "will".

When they see you, they quickly move to the game room.

>w
Dining Room
There is a china cabinet in the corner and a long oaken dining table with a large centerpiece and ten placecards set around the table. 

There is no placecard for you. The kitchen is to the north. The sitting room is to the south.

Anne sits at the table with her head in her hands.

>e
Hall
This great hall connects you to the rest of the house. To the southwest is the sitting room, where most of the family is. To the northwest, the kitchen. To the north is the bathroom, to the northeast the game room, the southeast, the library, and the south is the vestibule. Near the bathroom, a stairway leads up to the second floor. Cartwright stands guard in front of it. Next to him, a hunting trophy also stands guard.

>go w
Dining Room
There is a china cabinet in the corner and a long oaken dining table with a large centerpiece and ten placecards set around the table. 

There is no placecard for you. The kitchen is to the north. The sitting room is to the south.

Anne sits at the table with her head in her hands.

>west
You can't go that way.

>east
Hall
This great hall connects you to the rest of the house. To the southwest is the sitting room, where most of the family is. To the northwest, the kitchen. To the north is the bathroom, to the northeast the game room, the southeast, the library, and the south is the vestibule. Near the bathroom, a stairway leads up to the second floor. Cartwright stands guard in front of it. Next to him, a hunting trophy also stands guard.

>nw
Kitchen
The kitchen is mostly filled with a small militia of busy caterers. They bustle around not paying you any attention.

On the plus side they probably won't care if you take anything.

Unfortunately they are currently occupying three quarters of the room.

You can reach the pantry to the north of the kitchen or head into the dining room to the south. The counter you can reach holds a delicate tea cup, an empty bottle, a pocket-sized recipe book, and some loose grapes.

> take recipe book
You stuff it in your pocket as surreptitiously as you can.

>x recipe book
A pocket-sized guide to culinary and confectionery competence, a tome of dark instruction in the unknown arts.

>open recipe book
It isn't something you can open.

* * *

>[enter]
You can kind of understand why Uncle Clifton's family don't like you.

you can't take it with you
a take all game by take all games
Release 2 / Serial number 200726 / Inform 7 build 6M62 (I6/v6.33 lib 6/12N) SD
Type HELP for more information.

Vestibule
The entranceway of Uncle Clifton's imposing mansion, the anteroom of the Hall to the north. On your left, a weathered wooden umbrella stand sits, one lonely umbrella inside it. Next to it, a table has been set up for the condolence book, which lies open, and a pen.

I beg your pardon?

>n
Hall
This great hall connects you to the rest of the house. To the southwest is the sitting room, where most of the family is. To the northwest, the kitchen. To the north is the bathroom, to the northeast the game room, the southeast, the library, and the south, where you just came from, is the vestibule. Near the bathroom, a stairway leads up to the second floor. Cartwright stands guard in front of it. Next to him, a hunting trophy also stands guard.

Cedric and Bryce whisper about something. You can only make out the words "alter" and "will".

When they see you, they quickly move to the game room.

* * *

>w
Lawn
A clearing full of lush green grass. A table is set up with, at this point, just peanut butter canapés. Standing near the table is Hildegard, a rare friendly face.

>take canape
You can't see any such thing.

* * *

>[enter]
You can kind of understand why Uncle Clifton's family don't like you.

you can't take it with you
a take all game by take all games
Release 2 / Serial number 200726 / Inform 7 build 6M62 (I6/v6.33 lib 6/12N) SD
Type HELP for more information.

Vestibule
The entranceway of Uncle Clifton's imposing mansion, the anteroom of the Hall to the north. On your left, a weathered wooden umbrella stand sits, one lonely umbrella inside it. Next to it, a table has been set up for the condolence book, which lies open, and a pen.

>go north
Hall
This great hall connects you to the rest of the house. To the southwest is the sitting room, where most of the family is. To the northwest, the kitchen. To the north is the bathroom, to the northeast the game room, the southeast, the library, and the south, where you just came from, is the vestibule. Near the bathroom, a stairway leads up to the second floor. Cartwright stands guard in front of it. Next to him, a hunting trophy also stands guard.

Cedric and Bryce whisper about something. You can only make out the words "alter" and "will".

When they see you, they quickly move to the game room.

>go nw
Kitchen
The kitchen is mostly filled with a small militia of busy caterers. They bustle around not paying you any attention.

On the plus side they probably won't care if you take anything.

Unfortunately they are currently occupying three quarters of the room.

You can reach the pantry to the north of the kitchen or head into the dining room to the south. The counter you can reach holds a delicate tea cup, an empty bottle, a pocket-sized recipe book, and some loose grapes.

>go north
You close the pantry door behind you.

Pantry
A dark and mostly empty pantry. You can just fit yourself comfortably inside it with the door closed. On the dusty shelf at eye-level, you can see a can of beans, a can of corn, a mystery can, and a key. The kitchen to the south is the only exit.

>wait
Time passes.

>wait
Time passes.

> take can of corn
You stuff it in your pocket as surreptitiously as you can.

>eat corn
That's plainly inedible.

>go south
You open the pantry door, and leave.

Kitchen
The kitchen is mostly filled with a small militia of busy caterers. They bustle around not paying you any attention.

On the plus side they probably won't care if you take anything.

Unfortunately they are currently occupying three quarters of the room.

You can reach the pantry to the north of the kitchen or head into the dining room to the south. 

Rowan searches the kitchen for something to eat.

>eat loose grapes
You aren't in the mood for eyeballs.

* * *

>go north
You close the pantry door behind you.

Pantry
A dark and mostly empty pantry. You can just fit yourself comfortably inside it with the door closed. On the dusty shelf at eye-level, you can see a can of beans, a can of corn, a mystery can, and a key. The kitchen to the south is the only exit.

>open can
Which do you mean, the can of beans, the can of corn or the mystery can?

>open beans
You gnaw on the metal can, but to no avail.

* * *

>go nw
Kitchen
The kitchen is mostly filled with a small militia of busy caterers. They bustle around not paying you any attention.

On the plus side they probably won't care if you take anything.

Unfortunately they are currently occupying three quarters of the room.

You can reach the pantry to the north of the kitchen or head into the dining room to the south. The counter you can reach holds a delicate tea cup, an empty bottle, a pocket-sized recipe book, and some loose grapes.

>take grapes
This is a funeral reception and everyone knows you're a kleptomaniac. You're not going to intentionally take anything you aren't supposed to.

>wait
Time passes.

* * *

>wait
Time passes.

Rowan enters, searching for a snack.

>go north
You close the pantry door behind you.

Pantry
A dark and mostly empty pantry. You can just fit yourself comfortably inside it with the door closed. On the dusty shelf at eye-level, you can see a can of beans, a can of corn, a mystery can, and a key. The kitchen to the south is the only exit.

>go south
You open the pantry door, and leave.

Kitchen
The kitchen is mostly filled with a small militia of busy caterers. They bustle around not paying you any attention.

On the plus side they probably won't care if you take anything.

Unfortunately they are currently occupying three quarters of the room.

You can reach the pantry to the north of the kitchen or head into the dining room to the south. 

Rowan searches the kitchen for something to eat.

> take Loose grapes
You stuff it in your pocket as surreptitiously as you can.

>e
You just can't help yourself, can you.

>[enter]
"THIEF! THIEF!"

* * *

>go nw
Kitchen
The kitchen is mostly filled with a small militia of busy caterers. They bustle around not paying you any attention.

On the plus side they probably won't care if you take anything.

Unfortunately they are currently occupying three quarters of the room.

You can reach the pantry to the north of the kitchen or head into the dining room to the south. The counter you can reach holds a delicate tea cup, an empty bottle, a pocket-sized recipe book, and some loose grapes.

>examine grapes
If you close your eyes, you can pretend these are eyeballs. If that's something you're into.

>go north
You close the pantry door behind you.

Pantry
A dark and mostly empty pantry. You can just fit yourself comfortably inside it with the door closed. On the dusty shelf at eye-level, you can see a can of beans, a can of corn, a mystery can, and a key. The kitchen to the south is the only exit.

* * *

>wait
Time passes.

>wait
Time passes.

> take can of beans
You stuff it in your pocket as surreptitiously as you can.

>wait
Time passes.

>go south
You open the pantry door, and leave.

Kitchen
The kitchen is mostly filled with a small militia of busy caterers. They bustle around not paying you any attention.

On the plus side they probably won't care if you take anything.

Unfortunately they are currently occupying three quarters of the room.

You can reach the pantry to the north of the kitchen or head into the dining room to the south. 

Rowan searches the kitchen for something to eat.

>go north
You close the pantry door behind you.

Pantry
A dark and mostly empty pantry. You can just fit yourself comfortably inside it with the door closed. On the dusty shelf at eye-level, you can see a can of beans, a can of corn, a mystery can, and a key. The kitchen to the south is the only exit.

* * *

>wait
Time passes.

>wait
Time passes.

> take key
You stuff it in your pocket as surreptitiously as you can.

>go south
You open the pantry door, and leave.

Kitchen
The kitchen is mostly filled with a small militia of busy caterers. They bustle around not paying you any attention.

On the plus side they probably won't care if you take anything.

Unfortunately they are currently occupying three quarters of the room.

You can reach the pantry to the north of the kitchen or head into the dining room to the south. 

Rowan searches the kitchen for something to eat.

* * *

>go w
Dining Room
There is a china cabinet in the corner and a long oaken dining table with a large centerpiece and ten placecards set around the table. 

There is no placecard for you. The kitchen is to the north. The sitting room is to the south.

Anne sits at the table with her head in her hands.

>look
Dining Room
There is a china cabinet in the corner and a long oaken dining table with a large centerpiece and ten placecards set around the table. 

There is no placecard for you. The kitchen is to the north. The sitting room is to the south.

Anne sits at the table with her head in her hands.

>examine table
The centerpiece takes up alot of room on the table but you can see the ten placecards:

Dane's placecard
Anne's placecard
Rowan's placecard
Hildegard's placecard
Dimia's placecard
Beatrix's placecard
Bryce's placecard
Cartwright's placecard
Cedric's placecard
Edmund's placecard.

>examine dane's
It reads: Dane Fenwick.

* * *

>[enter]
You can kind of understand why Uncle Clifton's family don't like you.

you can't take it with you
a take all game by take all games
Release 2 / Serial number 200726 / Inform 7 build 6M62 (I6/v6.33 lib 6/12N) SD
Type HELP for more information.

Vestibule
The entranceway of Uncle Clifton's imposing mansion, the anteroom of the Hall to the north. On your left, a weathered wooden umbrella stand sits, one lonely umbrella inside it. Next to it, a table has been set up for the condolence book, which lies open, and a pen.

>inv
You are carrying:
  Cartwright's wallet
  Church pew pencils
  a hymnal

>examine pencils
There wasn't much to steal at the funeral, so your compulsion forced you to grab these. You've got at least ten of them.

* * *

>[enter]
You can kind of understand why Uncle Clifton's family don't like you.

you can't take it with you
a take all game by take all games
Release 2 / Serial number 200726 / Inform 7 build 6M62 (I6/v6.33 lib 6/12N) SD
Type HELP for more information.

Vestibule
The entranceway of Uncle Clifton's imposing mansion, the anteroom of the Hall to the north. On your left, a weathered wooden umbrella stand sits, one lonely umbrella inside it. Next to it, a table has been set up for the condolence book, which lies open, and a pen.

>go n
Hall
This great hall connects you to the rest of the house. To the southwest is the sitting room, where most of the family is. To the northwest, the kitchen. To the north is the bathroom, to the northeast the game room, the southeast, the library, and the south, where you just came from, is the vestibule. Near the bathroom, a stairway leads up to the second floor. Cartwright stands guard in front of it. Next to him, a hunting trophy also stands guard.

Cedric and Bryce whisper about something. You can only make out the words "Will" and "alter".

When they see you, they quickly move to the game room.

>go n
Bathroom
A small but opulent bathroom. By the sink you can see soap, a roll of toilet paper, lotion, sunglasses, and a glass eye. There is a plunger and a flashlight at the foot of the toilet. Slung over the towl rack are fancy towels and an ostentatious scarf. The only exit is back south into the hall.

>look
Bathroom
A small but opulent bathroom.  The only exit is back south into the hall.

>examine towels
Clean black towels with "C. F." embroidered on the corner in gold thread, ensuring these towels are easily identifiable in case of theft.

>take towels
This is a funeral reception and everyone knows you're a kleptomaniac. You're not going to intentionally take anything you aren't supposed to.

>wait
Time passes.

>wait
Time passes.

> take soap
You stuff it in your pocket as surreptitiously as you can.

>wait
Time passes.

>wiat
That's not a verb I recognise.

>wait
Time passes.

>wait
Time passes.

> take sunglasses
You stuff it in your pocket as surreptitiously as you can.

>inv
You are carrying:
  sunglasses
  a soap
  Cartwright's wallet
  church pew pencils
  a hymnal

>examine sunglasses
Dark aviator sunglasses. Goes well with a cowboy hat.

>wait
Time passes.

>wait
Time passes.

> take ostentatious scarf
You stuff it in your pocket as surreptitiously as you can.

>wait
Time passes.

>wait
Time passes.

> take roll of toilet paper
You stuff it in your pocket as surreptitiously as you can.

>wait
Time passes.

>wait
Time passes.

> take Fancy towels
You stuff it in your pocket as surreptitiously as you can.

>inv
You are carrying:
  Fancy towels
  a roll of toilet paper
  an ostentatious scarf
  sunglasses
  a soap
  Cartwright's wallet
  church pew pencils
  a hymnal

* * *

>go n
Bathroom
A small but opulent bathroom. By the sink you can see soap, a roll of toilet paper, lotion, sunglasses, and a glass eye. There is a plunger and a flashlight at the foot of the toilet. Slung over the towl rack are fancy towels and an ostentatious scarf. The only exit is back south into the hall.

>wait
Time passes.

>wait
Time passes.

> take flashlight
You stuff it in your pocket as surreptitiously as you can.

>wait
Time passes.

>wait
Time passes.

> take plunger
You stuff it in your pocket as surreptitiously as you can.

>wait
Time passes.

* * *

>wait
Time passes.

> take sunglasses
You stuff it in your pocket as surreptitiously as you can.

>wait
Time passes.

>wait
Time passes.

> take glass eye
You stuff it in your pocket as surreptitiously as you can.

>wait
Time passes.

>wait
Time passes.

> take bar of soap
You stuff it in your pocket as surreptitiously as you can.

>wait
Time passes.

>inv
You are carrying:
  a bar of soap
  a glass eye
  an ostentatious scarf
  sunglasses
  a plunger
  a flashlight
  Cartwright's wallet
  church pew pencils
  a hymnal

>wait
Time passes.

> take fancy towels
You stuff it in your pocket as surreptitiously as you can.

>inv
You are carrying:
  fancy towels
  a bar of soap
  a glass eye
  an ostentatious scarf
  sunglasses
  a plunger
  a flashlight
  Cartwright's wallet
  church pew pencils
  a hymnal

* * *

>go nw
Kitchen
The kitchen is mostly filled with a small militia of busy caterers. They bustle around not paying you any attention.

On the plus side they probably won't care if you take anything.

Unfortunately they are currently occupying three quarters of the room.

You can reach the pantry to the north of the kitchen or head into the dining room to the south. The counter you can reach holds a delicate tea cup, an empty bottle, a pocket-sized recipe book, and some loose grapes.

>examine caterers
They crowd most of the room like a hivemind, moving in synchronized movement like a sentient liquid in a religious fervor, only speaking to eachother in loud, quick barks.

They completely ignore you.
Which is something of a relief.

>examine counter
You see nothing special about the counter.

>look
Kitchen
The kitchen is mostly filled with a small militia of busy caterers. They bustle around not paying you any attention.

On the plus side they probably won't care if you take anything.

Unfortunately they are currently occupying three quarters of the room.

You can reach the pantry to the north of the kitchen or head into the dining room to the south. 

Rowan enters, searching for a snack.

* * *

>[enter]
You can kind of understand why Uncle Clifton's family don't like you.

you can't take it with you
a take all game by take all games
Release 2 / Serial number 200726 / Inform 7 build 6M62 (I6/v6.33 lib 6/12N) SD
Type HELP for more information.

Vestibule
The entranceway of Uncle Clifton's imposing mansion, the anteroom of the Hall to the north. On your left, a weathered wooden umbrella stand sits, one lonely umbrella inside it. Next to it, a table has been set up for the condolence book, which lies open, and a pen.

>i
You are carrying:
  Cartwright's wallet
  Church pew pencils
  a hymnal

>x pencils
There wasn't much to steal at the funeral, so your compulsion forced you to grab these. You've got at least ten of them.

>drop pencils
It might not be a good idea to give grieving rich people concrete evidence that you're stealing from them.

>x hymnal
The church where the funeral was held has a lot of these, but you still feel bad for taking it.

On the plus side, you'll never forget the words to "O, For A Thousand Tongues To Sing."

* * *

>i
You are carrying:
  Cartwright's wallet
  Church pew pencils
  a hymnal

>version
you can't take it with you
a struggle with kleptomania by take all games
Release 1 / Serial number 200725 / Inform 7 build 6M62 (I6/v6.33 lib 6/12N) SD
Type HELP for more information.
Identification number: //E1FC1A19-5864-4DCA-9A9B-481EFE402AFF//
Interpreter version 0.5.4 / VM 3.1.2 / Library serial number 080126
Standard Rules version 3/120430 by Graham Nelson

* * *

>[enter]
In about a seven count, you're going to take something else, even though you don't want to.

>i
You can kind of understand why Uncle Clifton's family don't like you.

you can't take it with you
a struggle with kleptomania by take all games
Release 1 / Serial number 200725 / Inform 7 build 6M62 (I6/v6.33 lib 6/12N) SD
Type HELP for more information.

Vestibule
The entranceway of Uncle Clifton's imposing mansion, the anteroom of the Hall to the north. On your left, a weathered wooden umbrella stand sits, one lonely umbrella inside it. Next to it, a table has been set up for the condolence book, which lies open, and a pen.

>inv
You are carrying:
  a Cartwright's wallet
  a church pew pencils
  a hymnal

* * *

>[enter]
His wallet fell out of his pocket. It's sitting on the floor.

>\
> take wallet
You stuff it in your pocket as surreptitiously as you can.

>[enter]
In about a seven count, you're going to take something else, even though you don't want to.

>[enter]
You can kind of understand why Uncle Clifton's family don't like you.

you can't take it with you
a struggle with kleptomania by take all games
Release 1 / Serial number 200724 / Inform 7 build 6M62 (I6/v6.33 lib 6/12N) SD
Type HELP for more information.

Vestibule
The entranceway of Uncle Clifton's imposing mansion, the anteroom of the Hall to the north. On your left, a weathered wooden umbrella stand sits, one lonely umbrella inside it. Next to it, a table has been set up for the condolence book, which lies open, and a pen.

>wait
Time passes.

>z
Time passes.

>z
Time passes.

>z
Time passes.

> take pen
You stuff it in your pocket as surreptitiously as you can.

>look
Vestibule
The entranceway of Uncle Clifton's imposing mansion, the anteroom of the Hall to the north. On your left, a weathered wooden umbrella stand sits, one lonely umbrella inside it. Next to it, a table has been set up for the condolence book, which lies open.

* * *

>[enter]
He gently took the pocketwatch back and promised you that someday, when he was gone, it would be yours.

He wasn't even really your uncle. Something like a father of a cousin of an in-law. A guy you mostly met at reunions at his house when you were a kid, the guy with the family that hates you.

* * *

>[enter]
He was awful, probably.

* * *

>[enter]
He wasn't even really your uncle. Something like a father of a cousin of an in-law. A guy you mostly met at reunions at his house when you were a kid, the guy with the family that hates you.

He wasn't even really your uncle. Something like a father of a cousin of an in-law. A guy you mostly met at reunions at his house when you were a kid, the guy with the family that hates you.

He ran a real estate company. Made millions off the backs of his employees and the people who lived in his properties. You don't get the kind of money he had by being a good person.

He was awful, probably.

He was one of the few people who bothered to understand you.

* * *

He caught you once, in your teens, stealing his silver pocketwatch from on top of his desk. He didn't get mad. He'd figured it out, before anyone else. You had kleptomania. An uncontrollable compulsion.

He gently took the pocketwatch back and promised you that someday, when he was gone, it would be yours.

That's why you're sitting in your car in front of his house, trying to convince yourself to brave the funeral reception so you can sneak upstairs, take the nicest present anyone's ever given you, and finally say goodbye to his family for good.

You get out of the car, nervously walk up to the front door, open it, and run smack dab into Cartwright.

He gives you a dirty look and walks off into the hall.

His wallet fell out of his pocket. It's sitting on the floor.

> take wallet
You stuff it in your pocket as surreptitiously as you can.

In about a seven count, you're going to take something else, even though you don't want to.

You can kind of understand why Uncle Clifton's family don't like you.

you can't take it with you
a take all game by take all games
Release 1 / Serial number 200725 / Inform 7 build 6M62 (I6/v6.33 lib 6/12N) SD
Type HELP for more information.

Vestibule
The entranceway of Uncle Clifton's imposing mansion, the anteroom of the Hall to the north. On your left, a weathered wooden umbrella stand sits, one lonely umbrella inside it. Next to it, a table has been set up for the condolence book, which lies open, and a pen.

>xyzzy
A hollow voice calls you a "dumbass." A fond memory of Uncle Clifton.

* * *

Uncle Clifton is dead.

[Press ENTER to continue.]

>[back]
Uncle Albert in a Can
A struggle with kleptomania by Unnamed Game Jam Team
Release 1 / Serial number 200711 / Inform 7 build 6M62 (I6/v6.33 lib 6/12N) SD

Foyer
The foyer of your great uncle's home.

It's a testthing.

* * *

Uncle Clifton is dead.

[Press ENTER to continue.]

>w
Uncle Albert in a Can
A struggle with kleptomania by Unnamed Game Jam Team
Release 1 / Serial number 200711 / Inform 7 build 6M62 (I6/v6.33 lib 6/12N) SD

Foyer
The foyer of your uncle's home.

You can see John here.

>wait
Time passes.

>wait
Time passes.

> take Testthing
You stuff it in your pocket as surreptitiously as you can.

>[enter]
You just can't help yourself, can you.

* * *

>[enter]
"THIEF! THIEF!"

>[enter]
Curb

    *** You have been thrown out ***

Would you like to RESTART, RESTORE a saved game, QUIT or UNDO the last command?

* * *

>d
Uncle Albert in a Can
A struggle with kleptomania by Unnamed Game Jam Team
Release 1 / Serial number 200711 / Inform 7 build 6M62 (I6/v6.33 lib 6/12N) SD

Vestibule
The entranceway of Uncle Clifton's imposing mansion. On your left, a weathered wooden umbrella stand sits, one lonely umbrella inside it.

* * *

Uncle Clifton is dead.

[Press ENTER to continue.]

>e
Uncle Albert in a Can
A struggle with kleptomania by Unnamed Game Jam Team
Release 1 / Serial number 200711 / Inform 7 build 6M62 (I6/v6.33 lib 6/12N) SD

Vestibule
The entranceway of Uncle Clifton's imposing mansion, the anteroom to the Hall to the north. On your left, a weathered wooden umbrella stand sits, one lonely umbrella inside it.  Next to it, a table has been set up for the condolence book, which lies open, and a pen.

>n
Hall
s

You can see Cartwright here.

>x vestibule
It looks smaller from here. Or maybe you're just farther away from it.

* * *

Uncle Clifton is dead.

[Press ENTER to continue.]

>f
He wasn't even really your uncle. Something like a father of a cousin of an in-law. A guy you mostly met at reunions at his house when you were a kid, the guy with the family that hates you.

>n
Hall
s

You can see Cartwright here.

>x vestibule
The entranceway of Uncle Clifton's imposing mansion, the anteroom to the Hall to the north. On your left, a weathered wooden umbrella stand sits, one lonely umbrella inside it.  Next to it, a table has been set up for the condolence book, which lies open, and a pen.

* * *

He wasn't even really your uncle. Something like a father of a cousin of an in-law. A guy you mostly met at reunions at his house when you were a kid, the guy with the family that hates you.

* * *

He ran a real estate company. Made millions off the backs of his employees and the people who lived in his properties. You don't get the kind of money he had by being a good person.

>[enter]
He was awful, probably.

* * *

>[esc]
He caught you once, in your teens, stealing his silver pocketwatch from on top of his desk. He didn't get mad. He'd figured it out, before anyone else. You had kleptomania. An uncontrollable compulsion.

>[esc]
He gently took the pocketwatch back and promised you that someday, when he was gone, it would be yours.

>[esc]
That's why you're sitting in your car in front of his house, trying to convince yourself to brave the funeral reception so you can sneak upstairs, take the nicest present anyone's ever given you, and finally say goodbye to his family for good.

* * *

>[enter]
He wasn't even really your uncle. Something like a father of a cousin of an in-law. A guy you mostly met at reunions at his house when you were a kid, the guy with the family that hates you.

* * *

Uncle Clifton is dead.

[Press ENTER to continue.]

>g
Uncle Albert in a Can
A struggle with kleptomania by Unnamed Game Jam Team
Release 1 / Serial number 200712 / Inform 7 build 6M62 (I6/v6.33 lib 6/12N) SD

Vestibule
The entranceway of Uncle Clifton's imposing mansion, the anteroom to the Hall to the north. On your left, a weathered wooden umbrella stand sits, one lonely umbrella inside it. Next to it, a table has been set up for the condolence book, which lies open, and a pen.

>go north
Hall
s

You can see Cartwright here.

* * *

>go north
Bathroom
A small but opulent bathroom. The only exit is back into the hall.

>examine scarf
"It's truly truly outrageous
truly truly truly outrageous."

-Jem and The Holograms, Truly Outrageous.

* * *

Uncle Clifton is dead.

[Press ENTER to continue.]

>d
He wasn't even really your uncle. Something like a father of a cousin of an in-law. A guy you mostly met at reunions at his house when you were a kid, the guy with the family that hates you.

>[enter]
He ran a real estate company. Made millions off the backs of his employees and the people who lived in his properties. You don't get the kind of money he had by being a good person.

* * *

>[enter]
He caught you once, in your teens, stealing his silver pocketwatch from on top of his desk. He didn't get mad. He'd figured it out, before anyone else. You had kleptomania. An uncontrollable compulsion.

* * *

>[enter]
In about a seven count, you're going to take something else, even though you don't want to.

>[enter]
You can kind of understand why Uncle Clifton's family don't like you.

you can't take it with you
a struggle with kleptomania by Unnamed Game Jam Team
Release 1 / Serial number 200712 / Inform 7 build 6M62 (I6/v6.33 lib 6/12N) SD

Vestibule
The entranceway of Uncle Clifton's imposing mansion, the anteroom of the Hall to the north. On your left, a weathered wooden umbrella stand sits, one lonely umbrella inside it. Next to it, a table has been set up for the condolence book, which lies open, and a pen.

>n
Hall
This great hall connects you to the rest of the house. To the southwest is the sitting room, where most of the family is. To the northwest, the kitchen. To the north is the bathroom, to the northeast the game room, the southeast, the library, and the south, where you just came from, is the vestibule. Near the bathroom, a stairway leads up to the second floor. Cartwright stands guard in front of it.

>sw
Sitting Room
A crowd of family and friends share condolences and fond memories of Uncle Clifton, drink champagne, and eat the hors d'oeuvres that remain on their napkins. Dimia sits in the middle of it all, looking past you, a hard-to-read expression on her face. The couch is loaded down with stuff: a pack of cigarettes and its ashtray, balanced precariously; a clutch; a cardigan and a leather jacket, draped over the couch next to each other; an empty china plate; and a golden watch. A chess set sits to the side of the room, on a game table, and a forgotten champagne flute sits on top of it.

To the west, a door is open to the lawn, where the remaining hors d'oeuvres are laid out. Barely anyone's out there.

* * *

>w
Lawn
A clearing full of lush green grass. A table is set up with, at this point, just peanut butter canapés. Standing near the table is Hildegard, a rare friendly face.

>take peanut butter canapé
Taken.

>eat peanut butter canapé
You eat the peanut butter canapé. Not bad.

>x hildegard
Anne's daughter. You've known each other growing up, since she's only a few years younger than you. She tends to get overstimulated at social gatherings, so you'll often find her somewhere quieter.

She's the only person other than Uncle Clifton who seems to understand what you're going through. She's covered for you in a few tense situations, pretending to "find" things you unintentionally stole, as long as you gave the thing to her.

>wait
Time passes.

Your fingers itch.

* * *

Uncle Clifton is dead.

[Press ENTER to continue.]

He wasn't even really your uncle. Something like a father of a cousin of an in-law. A guy you mostly met at reunions at his house when you were a kid, the guy with the family that hates you.

* * *

You can kind of understand why Uncle Clifton's family don't like you.

you can't take it with you
a take all game by take all games
Release 1 / Serial number 200725 / Inform 7 build 6M62 (I6/v6.33 lib 6/12N) SD
Type HELP for more information.

Vestibule
The entranceway of Uncle Clifton's imposing mansion, the anteroom of the Hall to the north. On your left, a weathered wooden umbrella stand sits, one lonely umbrella inside it. Next to it, a table has been set up for the condolence book, which lies open, and a pen.

>check inventory
There's no need to be so formal. They're your pockets. Try "inventory" or "inv" or my personal favorite, "i."

>inv
You are carrying:
  Cartwright's wallet
  church pew pencils
  a hymnal

* * *

You can kind of understand why Uncle Clifton's family don't like you.

you can't take it with you
a take all game by take all games
Release 1 / Serial number 200725 / Inform 7 build 6M62 (I6/v6.33 lib 6/12N) SD
Type HELP for more information.

Vestibule
The entranceway of Uncle Clifton's imposing mansion, the anteroom of the Hall to the north. On your left, a weathered wooden umbrella stand sits, one lonely umbrella inside it. Next to it, a table has been set up for the condolence book, which lies open, and a pen.

>n
Hall
This great hall connects you to the rest of the house. To the southwest is the sitting room, where most of the family is. To the northwest, the kitchen. To the north is the bathroom, to the northeast the game room, the southeast, the library, and the south, where you just came from, is the vestibule. Near the bathroom, a stairway leads up to the second floor. Cartwright stands guard in front of it. Next to him, a hunting trophy also stands guard.

Cedric and Bryce whisper about something. You can only make out the words "alter" and "will".

When they see you, they quickly move to the game room.

* * *

>wait
Time passes.

I beg your pardon?

>wait
Time passes.

>wait
Time passes.

Your fingers itch. There's nothing for them to take.

* * *

>wait
Time passes.

>wait
Time passes.

Hey, it's not stealing if it's free food.

> take peanut butter canapé
You stuff it in your pocket as surreptitiously as you can.

>take peanut butter canape
Hey, it's not stealing if it's free food.

Hey, it's not stealing if it's free food.

> take peanut butter canapé
You grab a canapé, grateful that taking hors d'oeuvres without asking is a normal thing to do.

You already have that.

* * *

>w
Lawn
A clearing full of lush green grass. A table is set up with, at this point, just peanut butter canapés. Standing near the table is Hildegard, a rare friendly face.

>z
Time passes.

>z
Time passes.

> take peanut butter canapé

* * *

>w
Lawn
A clearing full of lush green grass. A table is set up with, at this point, just peanut butter canapés. Standing near the table is Hildegard, a rare friendly face.

>take canape
Hey, it's not stealing if it's free food.

>wait
Time passes.

* * *

I beg your pardon?

>z
Time passes.

>z
Time passes.

> take peanut butter canapé
Hey, it's not stealing if it's free food.

Hildegard shrugs, and you shrug back. A private joke.

>i
You are carrying:
  two peanut butter canapés
  Cartwright's wallet
  church pew pencils
  a hymnal

>take peanut butter canape
Hey, it's not stealing if it's free food.

>i
You are carrying:
  three peanut butter canapés
  Cartwright's wallet
  church pew pencils
  a hymnal

>e
Sitting Room
A crowd of family and friends share condolences and fond memories of Uncle Clifton, drink champagne, and eat the hors d'oeuvres that remain on their napkins. Dimia sits in the middle of it all, looking past you, a hard-to-read expression on her face. The couch is loaded down with stuff: a pack of cigarettes and its ashtray, balanced precariously; a clutch; a cardigan and a leather jacket, draped over the couch next to each other; an empty china plate; and a golden watch. A chess set sits to the side of the room, on a game table, and a forgotten champagne flute sits on top of it.

To the west, a door is open to the lawn, where the remaining hors d'oeuvres are laid out. Hildegarde is out there.

>z
Time passes.

>z
Time passes.

> take champagne flute
You stuff it in your pocket as surreptitiously as you can.

* * *

You just can't help yourself, can you.

"THIEF! THIEF!"

*** You have been thrown out ***

Would you like to RESTART, RESTORE a saved game, QUIT or UNDO the last command?

>undo
Sitting Room
[Previous turn undone.]

>z
Time passes.

> take ashtray
You stuff it in your pocket as surreptitiously as you can.

* * *

>undo
Sitting Room
[Previous turn undone.]

>z
Time passes.

> take sweater
You stuff it in your pocket as surreptitiously as you can.